111111111111111111
1C00000PEC000000C1
111111111111111111
