11111111
100C0001
100E0001
100P00X1
10000001
11111111
