11111111
100C0001
100E0001
100P0001
100000E1
11111111
