11111111
10E00001
10000P00
10000001
100C0001
11111111
